1111111111
1P*T****C1
1********1
1C*******1
1*******T1
1*****M**1
1*M*****C1
1********1
1C**T***E1
1111111111