1111111111
1P******C1
1********1
1********1
1*******T1
1*****M**1
1********1
1********1
1C******E1
1111111111