1111111111
1P***1**C1
1****1***1
1****11**1
1*******T1
1*M***M**1
1***TC***1
1******111
1C******E1
1111111111