1111111111
1P**1***C1
1***1****1
1***1*M**1
1***C***T1
1*****M**1
1C*****1*1
1**M***111
1C******E1
1111111111