11111111111111111111
1P**********1***C**1
1*********C*1*T****1
1***********1******1
11******11111*M****1
11*****************1
1111**********M****1
1**1***************1
1*C1********M**T***1
1**1****T**********1
1**1******M********1
1T*1T***********1**1
1***********11111T*1
1T**********1***C**1
1*****M*****1******1
1*CT********1*T****1
1***********1******1
1*****M***T********1
1T******C*********E1
11111111111111111111